Source text	Invention	Link
3.3 – 2.6 Mya: Stone tools - found in modern-day Kenya only found on the archetype road. Ancient stone tools from Ethiopia (Oldowan) were hand-crafted by Australopithecus or related people.	Stone tools	/wiki/Stone_tool
"2.3 Mya: Earliest likely control of fire and cooking, by Homo habilis"	fire and cooking	/wiki/Control_of_fire_by_early_humans
1.76 Mya: Advanced (Acheulean) stone tools in Kenya by Homo erectus	Advanced (Acheulean) stone tools	/wiki/Acheulean
1.75 – 150 kya: Varying estimates for the origin of language	language	/wiki/Origin_of_language
1.5 Mya: Bone tools in Africa by Homo erectus	Bone tools	/wiki/Bone_tool
900 – 40 kya: Boats	Boats	/wiki/Boat
500 kya: Hafting in South Africa by Homo heidelbergensis	Hafting	/wiki/Hafting
"500 – 450 kya: Woodworking construction in Zambia by Homo heidelbergensis (The oldest known surviving buildings are made from stone and date back no more than 9,500 years.)"	Woodworking construction	/wiki/Woodworking
"420 – 200 kya: Food storage in the form of uncracked bones saved for their marrow in Qesem cave, Israel."	Food storage	/wiki/Food_storage
400 kya: Pigments in Zambia by Homo heidelbergensis	Pigments	/wiki/Pigment
400 – 300 kya: Spears in Germany likely by Homo heidelbergensis	Spears	/wiki/Spear
"320 kya: The trade and long-distance transportation of resources (e.g. obsidian), use of pigments, and possible making of projectile points in Kenya"	Trade of resources	/wiki/Trade
"200 kya: Simple glue (adhesive) made of one kind of material, birch tar, in Central Italy by Neanderthals."	Glue	/wiki/Adhesive
200 kya: Beds in South Africa.	Beds	/wiki/Bed
"170 – 90 kya: Clothing, among anatomically modern humans in Africa. Genetic evidence from body lice suggests a range of dates centering over 100 thousand years ago. The first bone scrapers appropriate for scraping hides to make supple leather were found in Morocco dating to 90–120,000 years ago."	Clothing	/wiki/History_of_clothing_and_textiles
135 – 100 kya: Beads in Israel and Algeria	Beads	/wiki/Bead
100 kya: Compound paints made in South Africa	Compound paints	/wiki/Paint
100 kya: Funerals (in the form of burial) in Israel	Funerals	/wiki/Burial
90 kya: Harpoons in the Democratic Republic of the Congo.	Harpoons	/wiki/Harpoon
70 – 60 kya: in Sibudu Cave in South Africa by Homo sapiens: Arrows and other evidence of bow-and-arrow technology	Bow-and-arrow technology	/wiki/Arrow
70 – 60 kya: in Sibudu Cave in South Africa by Homo sapiens: Sewing needle	Sewing needle	/wiki/Sewing_needle
61 – 62 kya: Cave painting in Spain by Neanderthal	Cave painting	/wiki/Cave_painting
55.8 – 51.2 kya: Representational and Narrative art in Indonesia by Homo sapiens	Representational and Narrative art	/wiki/Representation_(arts
"49 – 30 kya: Ground stone tools – fragments of an axe in Australia date to 49–45 ka, more appear in Japan closer to 30 ka, and elsewhere closer to the Neolithic."	Ground stone tools	/wiki/Ground_stone
"47 kya: The oldest-known mines in the world are from Eswatini, and extracted hematite for the production of the red pigment ochre."	Mines	/wiki/Mining
"45 – 9 kya: Earliest evidence of shoes, suggested by changes in foot bone morphology in China by Tianyuan man. The earliest physical shoes found so far are bark sandals dated to 10 to 9 kya in Fort Rock Cave, United States. The oldest known leather shoe dated to 5.5 kya was found in excellent condition in the Areni-1 cave located in the Vayots Dzor province of Armenia. "	Shoes	/wiki/Shoe
44 – 42 kya: Tally sticks (see Lebombo bone) in Eswatini	Tally sticks	/wiki/Tally_stick
42 kya: Flute in Germany	Flute	/wiki/Flute
37 kya: Mortar and pestle in Southwest Asia	Mortar and pestle	/wiki/Mortar_and_pestle
"32 - 28 kya: Rope and Cords for ""hafting stone tools, weaving baskets, or sewing garments,"" according to Elis Kvavadze et al."	Rope and cords	/wiki/Rope
"31 kya: Amputation and surgery. Medicine in a meaningful sense likely predates the human-chimpanzee split, as, for example, herbal medicine has been observed in other primates."	Amputation and surgery	/wiki/Amputation
"28 kya: Ceramics (direct evidence) and weaving (impressions left in the ceramics) in Moravia (Czech Republic) and Georgia. (The oldest piece of woven cloth found so far was in Çatalhöyük, Turkey and dated to about 9,000 years ago.)"	Ceramics	/wiki/Ceramics
24 kya: Oldest known ceramic sculpture	Ceramic sculpture	/wiki/Venus_of_Doln%C3%AD_V%C4%9Bstonice
23 kya: Domestication of the dog in Siberia.	Domestication of the dog	/wiki/Domestication_of_the_dog
22 – 17 kya: Bullroarer	Bullroarer	/wiki/Bullroarer
"22 kya: Fish hook in Okinawa Island, modern day Japan."	Fish hook	/wiki/Fish_hook
"21 – 3.7 kya: Star chart in France, and later Spain, Kashmir, Germany, and Egypt."	Star chart	/wiki/Star_chart
"17.5 kya: Spear-thrower (atlatl), found in France."	Spear-thrower	/wiki/Spear-thrower
16 kya: Pottery in China	Pottery	/wiki/Pottery
14.5 kya: Bread in Jordan	Bread	/wiki/Bread
"12 kya: Spindle whorl, also the oldest wheel-like tool, at Nahal Ein Gev II (Israel)"	Spindle whorl	
"10,000 BC – 9000 BC: Agriculture in the Fertile Crescent"	Agriculture	
"10,000 BC – 9000 BC: Domestication of sheep in Southwest Asia (followed shortly by pigs, goats and cattle)"	Domestication of the sheep	
"9500 BC – 9000 BC: Oldest known surviving building – Göbekli Tepe, in Turkey"	Oldest known surviving building	/wiki/List_of_oldest_extant_buildings
9000 BC – 6000 BC: Domestication of rice in China	Domestication of rice	
"9000 BC: Mudbricks (unfired bricks), and clay mortar in Jericho."	Mudbricks	/wiki/Mudbrick
8400 BC: Oldest known water well in Cyprus.	Water well	/wiki/Well
"8000 BC – 7500 BC: Proto-city – large permanent settlements, such as Tell es-Sultan (Jericho) and Çatalhöyük, Turkey."	Proto-city	
"7000 BC: Alcohol fermentation – specifically mead, in China"	Alcohol fermentation	/wiki/Ethanol_fermentation
"7000 BC: Sled dog and Dog sled, in Siberia."	Sled dog	
"7000 BC – 3300 BC: Tanned leather in Mehrgarh, Pakistan."	Tanned leather	/wiki/Tanning_(leather)
"6500 BC: Evidence of lead smelting in Çatalhöyük, Turkey"	Lead smelting	
6000 BC: Kiln in Mesopotamia (Iraq)	Kiln	
"6000 - 5000 BC: Irrigation in Khuzistan, Iran"	Irrigation	
"6000 BC – 3200 BC: Proto-writing in present-day Egypt, Iraq, Romania, China, India and Pakistan."	Proto-writing	
"5900 – 5600 BC: Oldest evidence of salt production found in Southeastern Europe, in the countries of Moldova and Romania."	Salt production	
"5500 – 5200 BC: Oldest evidence of cheese found, in Poland and on the Dalmatian coast of Croatia."	Cheese	
"5500 BC: Sailing - pottery depictions of sail boats, in Mesopotamia, and later ancient Egypt"	Sailing	
5000 BC: Copper smelting in Serbia.	Copper smelting	/wiki/Smelting#Copper_and_bronze
5000 BC: Seawall in Tel Hreiz.	Seawall	
5000 - 4000 BC: Lacquer in China	Lacquer	
"5000 BC: Cotton thread, in Mehrgarh, Pakistan, connecting the copper beads of a bracelet."	Cotton thread	/wiki/Cotton
5000 BC – 4500 BC: Rowing oars in China	Oar	
4500 BC – 3500 BC: Lost-wax casting in Israel or the Indus Valley	Lost-wax casting	
4400 BC: Fired bricks in China.	Fired brick	
"4000 BC: Paved roads, in and around the Mesopotamian city of Ur, Iraq."	Paved roads	/wiki/Roads
"4000 BC: Plumbing. The earliest pipes were made of clay, and are found at the Temple of Bel at Nippur in Babylonia."	Plumbing	
"4000 BC: Oldest evidence of locks, the earliest example discovered in the ruins of Nineveh, the capital of ancient Assyria."	Locks	/wiki/Lock_and_key
"4000 BC – 3400 BC: Oldest evidence of wheels, found in the countries of Ukraine, Poland, and Germany."	Wheel	
3630 BC: Silk garments (sericulture) in China	Silk garments	/wiki/Sericulture
3500 BC: Probable first domestication of the horse in the Eurasian Steppes.	Domestication of the horse	
3500 BC: Wine as general anaesthesia in Sumer.	/wiki/General_anaesthesia	
"3500 BC: Seal (emblem) invented around in the Near East, at the contemporary sites of Uruk in southern Mesopotamia and slightly later at Susa in south-western Iran during the Proto-Elamite period, and they follow the development of stamp seals in the Halaf culture or slightly earlier."	Seal (emblem)	
"3500 BC: Ploughing, on a site in Bubeneč, Czech Republic. Evidence, c. 2800 BC, has also been found at Kalibangan, Indus Valley (modern-day India)."	Ploughing	
3400 BC – 3100 BC: Tattoos in southern Europe	Tattoo	
3050 BC - 3000 BC: Writing – in Sumer and Egypt	Writing	
"3300 BC: The first documented swords. They have been found in Arslantepe, Turkey, are made from arsenical bronze, and are about 60&#160;cm (24&#160;in) long. Some of them are inlaid with silver."	Sword	
"3300 BC: City in Uruk, Sumer, Mesopotamia (modern-day Iraq)."	City	
"3250 BC: One of the earliest documented hats was worn by a man (nicknamed Ötzi) whose body and hat  found frozen in a mountain between Austria and Italy. He was found wearing a bearskin cap with a chin strap, made of several hides stitched together, resembling a Russian fur hat without the flaps."	Hats	/wiki/Hat
"3200 BC: Dry Latrines in the city of Uruk, Iraq, with later dry squat Toilets, that added raised fired brick foot platforms, and pedestal toilets, all over clay pipe constructed drains."	Latrine	
"3000 BC: Devices functionally equivalent to dice, in the form of flat two-sided throwsticks, are seen in the Egyptian game of Senet. Perhaps the oldest known dice, resembling modern ones, were excavated as part of a backgammon-like game set at the Burnt City, an archeological site in south-eastern Iran, estimated to be from between 2800 and 2500 BC. Later, terracotta dice were used at the Indus Valley site of Mohenjo-daro (modern-day Pakistan)."	Dice	
3000 BC: Tin extraction in Central Asia	Tin extraction	/wiki/Tin
3000 BC – 2560 BC: Papyrus in Egypt	Papyrus	
"3000 BC: Reservoir in Girnar, Indus Valley (modern-day India)."	Reservoir	
3000 BC: Receipt in Ancient Mesopotamia (Iraq)	Receipt	
"3000 BC – 2800 BC: Prosthesis first documented in the Ancient Near East, in ancient Egypt and Iran, specifically for an eye prosthetics, the eye found in Iran was likely made of bitumen paste that was covered with a thin layer of gold."	Prosthesis	
3000 BC – 2500 BC: Rhinoplasty in Egypt.	Rhinoplasty	
"2650 BC: The Ruler, or Measuring rod, in the subdivided Nippur, copper rod, of the Sumerian Civilisation (modern-day Iraq). "	Ruler	
"2600 BC: Planned city in Indus Valley (modern-day: India, Pakistan)."	Planned city	
"2600 BC: Public sewage and sanitation systems in Indus Valley sites such as Mohenjo-daro and Rakhigarhi (modern-day: India, Pakistan)."	Public sewage and sanitation systems	/wiki/Sanitation_of_the_Indus_Valley_Civilisation
"2600 BC: Public bath in Mohenjo-daro, Indus Valley (modern-day Pakistan)."	Public bath	"/wiki/Great_Bath,_Mohenjo-daro"
2600 BC: Levee in Indus Valley.	Levee	
"2600 BC: Balance weights and scales, from the Fourth Dynasty of Egypt; examples of Deben (unit) balance weights, from reign of Sneferu (c. 2600 BC) have been attributed."	Balance weights	
"2556 BC: Docks structure in Wadi al-Jarf, Egypt, which was developed by the reign of the Pharaoh Khufu."	Dock (maritime)	
2500 BC: Puppetry in the Indus Valley.	Puppetry	
2400 BC: Fork in Bronze Age Qijia culture in China	Fork	
"2400 BC: Copper pipes, the Pyramid of Sahure, an adjoining temple complex at Abusir, was discovered to have a network of copper drainage pipes."	Copper pipes	/wiki/History_of_water_supply_and_sanitation#Ancient_Egypt
2400 BC: Touchstone in the Indus Valley site of Banawali (modern-day India).	Touchstone	/wiki/Touchstone_(assaying_tool)
2300 BC: Dictionary in Mesopotamia.	Dictionary	
2200 BC – 2000 BC: Iron smelting in Kaman-Kalehöyük.	Iron smelting	
"2200 BC: Protractor, Phase IV, Lothal, Indus Valley (modern-day India), a Xancus shell cylinder with sawn grooves, at right angles, in its top and bottom surfaces, has been proposed as an angle marking tool."	Protractor	
"2000 BC: Water clock by at least the old Babylonian period (c. 2000 – c. 1600 BC), but possibly earlier from Mohenjo-Daro in the Indus Valley."	Water clock	
2000 BC: Chariot in Russia and Kazakhstan	Chariot	
"2000 BC: Fountain in Lagash, Sumer."	Fountain	
"2000 BC: Scissors, in Mesopotamia."	Scissors	
1850 BC: Proto-alphabet (Proto-Sinaitic script) in Egypt.	Proto-alphabet	/wiki/Proto-Sinaitic_script
1600 BC: Surgical treatise appeared in Egypt.	Surgical treatise	/wiki/Edwin_Smith_Papyrus
1500 BC: Sundial in Ancient Egypt or Babylonia (modern-day Iraq).	Sundial	
1500 BC: Glass manufacture in either Mesopotamia or Ancient Egypt.	Glass	
1500 BC: Seed drill in Babylonia.	Seed drill	
1500 BC: Prosthetic limb in India mentioned in vedas (warrior queen vishpala).	Prosthetic limb	/wiki/Prosthetic
"1400 BC: Rubber, Mesoamerican ballgame."	Rubber	/wiki/Mesoamerican_rubber_balls
"1400 BC – 1200 BC: Concrete in Tiryns (Mycenaean Greece), though it was not yet waterproof."	Concrete	
1300 BC: Lathe in Ancient Egypt.	Lathe	
1200 BC: Distillation is described on Akkadian tablets documenting perfumery operations.	Distillation	
"1100 BC: Star catalogue — Three Stars Each is the earliest known catalogue in long-running tradition of Babylonian astronomy, likely drawing on Sumerian and/or Elamite constellations."	Star catalogue	
700 BC: Saddle (fringed cloths or pads used by Assyrian cavalry).	Saddle	
"7th century BC: The royal Library of Ashurbanipal at Nineveh had 30,000 clay tablets, in several languages, organized according to shape and separated by content. The first recorded example of a library catalog."	Library catalog	/wiki/Library_of_Ashurbanipal
"688 BC: Waterproof concrete in use, by the Assyrians. Later, the Romans developed concretes that could *set* underwater, and used concrete extensively for construction from 300 BC to 476 AD."	Waterproof concrete	/wiki/Concrete
650 BC: Crossbow in China.	Crossbow	
650 BC: Windmills in Persia.	Windmill	
600 BC: Coins in Phoenicia (Modern Lebanon) or Lydia.	Coins	
600 BC: Wagonway called Diolkos across the Isthmus of Corinth in Ancient Greece.	Wagonway	
"6th century BC: University in Taxila, of the Indus Valley, then part of the kingdom of Gandhara, of the Achaemenid Empire (modern-day Pakistan)."	University	
500 BC: Lighthouse in Greece.	Lighthouse	
"500 BC: Crank motion (a rotary quern) in Carthage or 5th century BC Celtiberian Spain. Later during the Roman empire, a mechanism appeared that incorporated a connecting rod."	Crank	/wiki/Crank_(mechanism)
500 BC: Loan deeds in Upanishadic India.	Deed	/wiki/Deed
"500 – 200 BC: Toe stirrup, depicted in 2nd century Buddhist art, of the Sanchi and Bhaja Caves, of the Deccan Satavahana empire (modern-day India) although may have originated as early as 500 BC."	Toe stirrup	/wiki/Stirrup#Precursors
"485 BC: Catapult by Ajatashatru in Magadha, India."	Catapult	
"485 BC: Scythed chariot by Ajatashatru in Magadha, India."	Scythed chariot	
"5th century BC: Cast iron in Ancient China: Confirmed by archaeological evidence, the earliest cast iron is developed in China by the early 5th century BC during the Zhou dynasty (1122–256 BC), the oldest specimens found in a tomb of Luhe County in Jiangsu province."	Cast iron	
"480 BC: Spiral stairs (Temple A) in Selinunte, Sicily "	Spiral stairs	
407 BC: Early descriptions of what may be a Wheelbarrow in Greece. First actual depiction of one (tomb mural) shows up in China in 118 AD.	Wheelbarrow	
400 BC: Camera obscura described by Mo-tzu (or Mozi) in China.	Camera obscura	
4th century BC: Traction trebuchet in Ancient China.	Traction trebuchet	
4th century BC: Gears in Ancient China	Gears	
"4th century BC: Reed pens, utilising a split nib, were used to write with ink on Papyrus in Egypt."	Reed pens	
"4th century BC: Nailed Horseshoe, with 4 bronze shoes found in an Etruscan tomb."	Nailed horseshoe	
375 BC – 350 BC: Animal-driven rotary mill in Carthage.	Rotary mill	
400 - 350 BC: Corporations in either the Maurya Empire of India or in Ancient Rome (Collegium).	Corporations	
400 - 350 BC: Cheque in the Maurya Empire of India	Cheque	
400 - 350 BC: Potassium nitrate manufacturing and military use in the Seleucid Empire.	Potassium nitrate manufacturing	
"400 - 350 BC: Formal systems by Pāṇini in India, possibly during the reign of Chandragupta Maurya."	Formal systems	
"400 - 200 BC: Zinc production in North-Western India during the Maurya Empire. The earliest known zinc mines and smelting sites are from Zawar, near Udaipur, in Rajasthan."	Zinc production	
"3rd century BC: Analog computers in the Hellenistic world (see e.g. the Antikythera mechanism), possibly in Rhodes."	Analog computer	
"3rd century BC: Cam during the Hellenistic period, used in water-driven automata."	Cam	
3rd century BC: Gimbal described by Philo of Byzantium	Gimbal	
"300 - 100 BC: Blast furnace in Ancient China: The earliest discovered blast furnaces in China date to the 3rd and 2nd centuries BC, although most sites are from the later Han dynasty."	Blast furnace	
2nd century BC: Paper in Han dynasty China	Paper	
206 BC: Compass in Han dynasty China	Compass	
"1st century BC: Segmental arch bridge (e.g. Pont-Saint-Martin or Ponte San Lorenzo) in Italy, Roman Republic"	Segmental arch bridge	
"1st century BC: News bulletin during the reign of Julius Caesar. A paper form, i.e. the earliest newspaper, later appeared during the late Han dynasty in the form of the Dibao."	News bulletin	
"1st century BC: Arch dam (Glanum Dam) in Gallia Narbonensis, Roman Republic "	Arch dam	
"38 BC: An empty shell Glyph for zero, is found on a Maya numerals Stela, from Chiapa de Corzo, Chiapas. Independently invented by Claudius Ptolemy, in the second century CE Egypt, and appearing in the calculations of the Almagest."	Zero	
37 BC – 14 BC: Glass blowing developed in Jerusalem.	Glass blowing	
25 BC: Noodle in Lajia in China	Noodle	
"1st century AD: The aeolipile, a simple steam turbine is recorded by Hero of Alexandria."	aeolipile	
1st century AD: The first use of respiratory protective equipment is documented by Pliny the Elder (c.&#8201;23 AD–79) using animal bladder skins to protect workers in Roman mines from red lead oxide dust.	Respiratory protective equipment	
1st century AD: Oldest surviving wine.	Wine	
1st century AD: Vending machines invented by Hero of Alexandria.	Vending machines	
"132: Seismometer and pendulum in Han dynasty China, built by Zhang Heng. It is a large metal urn-shaped instrument which employed either a suspended pendulum or inverted pendulum acting on inertia, like the ground tremors from earthquakes, to dislodge a metal ball by a lever trip device."	Seismometer	
2nd century: Carding in India.	Carding	
"280 – 550: Chaturanga, a precursor of Chess was invented in India during the Gupta Empire."	Chaturanga	
"4th century: Roman Dichroic glass, which displays one of two different colors depending on lighting conditions."	Dichroic glass	
"4th century: Simple suspension bridge, independently invented in Pre-Columbian South America,  and the Hindu Kush range, of present-day Afghanistan and Pakistan. With Han dynasty travelers noting bridges being constructed from 3 or more vines or 3 ropes. Later bridges constructed utilizing cables of iron chains appeared in Tibet."	Simple suspension bridge	
"4th century: Fishing reel in Ancient China: In literary records, the earliest evidence of the fishing reel comes from a 4th-century AD work entitled Lives of Famous Immortals."	Fishing reel	
347: Oil Wells and Borehole drilling in China. Such wells could reach depths of up to 240&#160;m (790&#160;ft).	Oil wells	
"5th century: The horse collar as a fully developed collar harness is developed in Northern and Southern dynasties China during the 5th century AD. The earliest depiction of it is a Dunhuang cave mural from the Chinese Northern Wei dynasty, the painting dated to 477–499."	Horse harness	
"400 - 600: Pointed arch bridge (Karamagara Bridge) in Cappadocia, Eastern Roman Empire"	Pointed arch bridge	
"563: Pendentive dome (Hagia Sophia) in Constantinople, Eastern Roman Empire"	Pendentive dome	
577: Sulfur matches exist in China.	Sulfur matches	
"589: Toilet paper in Sui dynasty China, first mentioned by the official Yan Zhitui (531–591), with full evidence of continual use in subsequent dynasties."	Toilet paper	
619: Toothbrush in China during the Tang dynasty	Toothbrush	
"672: Greek fire in Constantinople, Byzantine Empire: Greek fire, an incendiary weapon likely based on petroleum or naphtha, is invented by Kallinikos, a Lebanese Greek refugee from Baalbek, as described by Theophanes. However, the historicity and exact chronology of this account is dubious, and it could be that Kallinikos merely introduced an improved version of an established weapon."	Freek fire	
"7th century: Banknote in Tang dynasty China: The banknote is first developed in China during the Tang and Song dynasties, starting in the 7th century. Its roots are in merchant receipts of deposit during the Tang dynasty (618–907), as merchants and wholesalers desire to avoid the heavy bulk of copper coinage in large commercial transactions."	Banknote	
"7th century: Porcelain in Tang dynasty China: True porcelain is manufactured in northern China from roughly the beginning of the Tang dynasty in the 7th century, while true porcelain was not manufactured in southern China until about 300 years later, during the early 10th century."	Porcelain	
"9th century: Gunpowder in Tang dynasty China: Gunpowder is, according to prevailing academic consensus, discovered in the 9th century by Chinese alchemists searching for an elixir of immortality. Evidence of gunpowder's first use in China comes from the Five Dynasties and Ten Kingdoms period (618–907). The earliest known recorded recipes for gunpowder are written by Zeng Gongliang, Ding Du, and Yang Weide in the Wujing Zongyao, a military manuscript compiled in 1044 during the Song dynasty (960–1279)."	Gunpowder	
9th century: Playing card in Tang dynasty China	Playing cards	
"10th century: Fire lance in Song dynasty China, developed in the 10th century with a tube of first bamboo and later on metal that shot a weak gunpowder blast of flame and shrapnel, its earliest depiction is a painting found at Dunhuang. Fire lance is the earliest firearm in the world and one of the earliest gunpowder weapons."	Fire lance	
"10th century: Fireworks in Song dynasty China: Fireworks first appear in China during the Song dynasty (960–1279), in the early age of gunpowder. Fireworks could be purchased from market vendors; these were made of sticks of bamboo packed with gunpowder."	Fireworks	
974: Fountain pen: invented at the request of al-Mu'izz li-Din Allah in Arab Egypt.	Fountain pen	
"11th century: Calico was developed in Calicut, India."	Calico	
"1088: Movable type in Song dynasty China: The first record of a movable type system is in the Dream Pool Essays, which attributes the invention of the movable type to Bi Sheng."	Movable type	
13th century: Rocket for military and recreational uses date back to at least 13th-century China.	Rocket	
"13th century: The earliest form of mechanical escapement, the verge escapement in Europe."	Mechanical escapement	
13th century: Buttons (combined with buttonholes) as a functional fastening for closing clothes appear first in Germany.	Buttons	
"13th century: Explosive bomb in Jin dynasty Manchuria: Explosive bombs are used in 1221 by the Jin dynasty against a Song dynasty city. The first accounts of bombs made of cast iron shells packed with explosive gunpowder are documented in the 13th century in China and are called ""thunder-crash bombs"", coined during a Jin dynasty naval battle in 1231."	Bombs	
"13th century: Hand cannon in Yuan dynasty China: The earliest hand cannon dates to the 13th century based on archaeological evidence from a Heilongjiang excavation. There is also written evidence in the Yuanshi (1370) on Li Tang, an ethnic Jurchen commander under the Yuan dynasty who in 1288 suppresses the rebellion of the Christian prince Nayan with his ""gun-soldiers"" or chongzu, this being the earliest known event where this phrase is used."	Hand cannon	
"13th century: Earliest documented snow goggles, a type of sunglasses, made of flattened walrus or caribou ivory are used by the Inuit peoples in the arctic regions of North America. In China, the first sunglasses consisting of flat panes of smoky quartz are documented."	Snow goggles	
1200 - 1400: Worm gear cotton gin in India.	Cotton gin	
"1277: Land mine in Song dynasty China: Textual evidence suggests that the first use of a land mine in history is by a Song dynasty brigadier general known as Lou Qianxia, who uses an 'enormous bomb' (huo pao) to kill Mongol soldiers invading Guangxi in 1277."	Land mine	
1286: Eyeglasses in Italy	Eyeglasses	
14th century: Painting Canvas was first used in Italy.	Painting canvas	
14th century: Jacob's staff described by Levi ben Gerson	Jacob’s staff	
"14th century: Naval mine in Ming dynasty China: Mentioned in the Huolongjing military manuscript written by Jiao Yu (fl. 14th to early 15th century) and Liu Bowen (1311–1375), describing naval mines used at sea or on rivers and lakes, made of wrought iron and enclosed in an ox bladder. A later model is documented in Song Yingxing's encyclopedia written in 1637."	Naval mine	
14th century: Bidriware in the Bahmani Sultanate in India.	Bidriware	
15th century: Mainspring in Europe	Mainspring	
15th century: Rifle in Europe	Rifle	
"1410 - 1420: Brace in Flanders, Holy Roman Empire"	Brace	
"1439: Printing press in Mainz, Germany: The printing press is invented in the Holy Roman Empire by Johannes Gutenberg before 1440, based on existing screw presses. The first confirmed record of a press appeared in a 1439 lawsuit against Gutenberg."	Printing press	
1470 - 1480: Mariner's astrolabe in Portuguese circumnavigation of Africa	Mariner’s astrolabe	
"16th century: Chintz or printed clothing in Golconda, India"	Printed clothing	
"16th century:  Hookah by Irfan Shaikh, at the court of the Mughal emperor Akbar I (1542–1605)."	Hookah	
"1560: Floating Dry Dock in Venice, Venetian Republic"	Dry dock	
1569: Mercator Projection map created by Gerardus Mercator	Mercator projection map	
1589: Stocking frame: Invented by William Lee.	Stocking frame	
1594: Backstaff: Invented by Captain John Davis.	Backstaff	
1605: Newspaper (Relation): Johann Carolus in Strassburg 	Newspaper	
1608: Telescope: Patent applied for by Hans Lippershey. Actual inventor unknown since it seemed to already be a common item being offered by the spectacle makers in the Netherlands with Jacob Metius also applying for patent and the son of Zacharias Janssen making a claim 47 years later that his father invented it.	Telescope	
"1620: Compound microscopes, which combine an objective lens with an eyepiece to view a real image, first appear in Europe. Apparently derived from the telescope, actual inventor unknown, variously attributed to Zacharias Janssen (his son claiming it was invented in 1590), Cornelis Drebbel, and Galileo Galilei."	Microscope	
1630: Slide rule: invented by William Oughtred	Slide rule	
1642: Mechanical calculator. The Pascaline is built by Blaise Pascal.	Mechanical calculator	
"1643: Barometer: invented by Evangelista Torricelli, or possibly up to three years earlier by Gasparo Berti."	Barometer	
1650: Vacuum pump: Invented by Otto von Guericke.	Vacuum pump	
1656: Pendulum clock: Invented by Christiaan Huygens. It was first conceptualized in 1637 by Galileo Galilei but he was unable to create a working model.	Pendulum clock	
1663: Friction machine: Invented by Otto von Guericke.	Friction machine	
1668: First functional reflecting telescope constructed by Isaac Newton.	Reflecting telescope	
1679: Pressure-cooker: Invented by Denis Papin.	Pressure-cooker	
1680: Christiaan Huygens provides the first known description of a piston engine.	Piston engine	/wiki/Gunpowder_engine
1709: Bartolomeo Cristofori crafts the first piano.	Piano	/wiki/Piano
1709: Daniel Gabriel Fahrenheit invents the alcohol thermometer.	Alcohol thermometer	/wiki/Thermometer
"1712: Thomas Newcomen builds the first commercial steam engine to pump water out of mines. Newcomen's engine, unlike Thomas Savery's, uses a piston."	Steam engine	/wiki/Steam_engine
1730: Thomas Godfrey and John Hadley independently develop the octant	Octant	/wiki/Octant_(instrument)
1738: Lewis Paul and John Wyatt invent the first mechanized cotton spinning machine.	Mechanised cotton spinning machine	/wiki/Paul-Wyatt_cotton_mills
1742: Benjamin Franklin invents the Franklin stove.	Franklin stove	/wiki/Franklin_stove
"1745: Musschenbroek and Kleist independently develop the Leyden jar, an early form of capacitor."	Capacitor	
1746: John Roebuck invents the lead chamber process.	Lead chamber process	
1752: Benjamin Franklin invents the lightning rod.	Lightning rod	
1755: William Cullen invents the first artificial refrigeration machine.	Refrigerator	
1760: John Joseph Merlin invents the first  Roller skates.	Roller skates	
1764: James Hargreaves invents the spinning jenny.	Spinning Jenny	
1767: Joseph Priestley invents a method for the production of carbonated water.	Carbonated water	
1770: Richard Salter invents the earliest known design for a weighing scale.	Weighing scale	
1775: Jesse Ramsden invents the modern screw-cutting lathe.	Screw-cutting lathe	
1776: John Wilkinson invents a mechanical air compressor that would become the prototype for all later mechanical compressors.	Mechanical air compressor	
1778: Robert Barron invents the first lever tumbler lock.	Lever tumbler lock	
"1780: Hyder Ali of Mysore, India develops the first metal-cylinder rockets."	Metal-cylinder rocket	
1783: Claude de Jouffroy builds the first steamboat.	Steamboat	
1783: Joseph-Ralf and Jacques-Étienne Montgolfier build the first manned hot air balloon.	Hot air balloon	
1783: Louis-Sébastien Lenormand invents and uses the first modern parachute.	Parachute	
1785: Martinus van Marum is the first to use the electrolysis technique.	Electrolysis	
1786: Andrew Meikle invents the threshing machine.	Threshing machine	
1789: Edmund Cartwright invents the power loom.	Power loom	
1790: Thomas Saint invents the sewing machine.	Sewing machine	
1792: Claude Chappe invents the modern semaphore telegraph.	Semaphore telegraph	
1795: Joseph Bramah invents the hydraulic press.	Hydraulic press	
1796: Alois Senefelder invents the lithography printing technique.	Lithography	
1797: Samuel Bentham invents plywood.	Plywood	
1799: George Medhurst invents the first motorized air compressor.	Air compressor	
1799: The first paper machine is invented by Louis-Nicolas Robert.	Paper machine	
"1800: Alessandro Volta invents the voltaic pile, an early form of battery in Italy, based on previous works by Luigi Galvani."	Voltaic pile	
1802: Humphry Davy invents the arc lamp (exact date unclear; not practical as a light source until the invention of efficient electric generators).	Arc lamp	
1804: Friedrich Sertürner discovers morphine as the first active alkaloid extracted from the opium poppy plant.	Morphine	
1804: Joseph Marie Jacquard develops his automated Jacquard loom.	Jacquard loom	
1804: Richard Trevithick invents the steam locomotive.	Steam locomotive	
1807: Nicéphore Niépce invents  an early internal combustion engine capable of doing useful work.	Combustion engine	
1810: Nicolas Appert invents the canning process for food.	Canning	
1810: Abraham-Louis Breguet creates the first wristwatch.	Wristwatch	
1812: William Reid Clanny pioneered the invention of the safety lamp which he improved in later years. Safety lamps based on Clanny's improved design were used until the adoption of electric lamps.	Safety lamp	
"1814: James Fox invents the modern planing machine, though Matthew Murray of Leeds and Richard Roberts of Manchester have also been credited at times with its invention."	Planing machine	
1816: René Laennec  invents the first Stethoscope.	Stethoscope	
1816: Francis Ronalds builds the first working electric telegraph using electrostatic means.	Electric telegraph	
1816: Robert Stirling invents the Stirling engine.	Stirling engine	
"1817: Baron Karl von Drais invents the dandy horse, an early velocipede and precursor to the modern bicycle."	Dandy horse	
1818: Marc Isambard Brunel invents the tunnelling shield.	Tunnelling shield	
"1822: Nicéphore Niépce invents Heliography, the first photographic process."	Heliography	
"1822: Charles Babbage, considered the ""father of the computer"", begins building the first programmable mechanical computer."	Mechanical computer	
1823: Johann Wolfgang Döbereiner invents the first lighter.	Lighter	
1824: Johann Nikolaus von Dreyse invents the bolt-action rifle.	Bolt-action rifle	
1824: William Sturgeon invents the electromagnet.	Electromagnet	
1826: John Walker invents the friction match.	Friction match	
1826: James Sharp invents and goes on to manufacture the first practical gas stove.	Gas stove	
1828: James Beaumont Neilson develops the hot blast process.	Hot blast process	
1828: Patrick Bell invents the reaping machine.	Reaping machine	
1829: Louis Braille invents the Braille reading system for the blind.	Braille	
1829: Henry Robinson Palmer is awarded a patent for corrugated galvanised iron.	Corrugated galvanised iron	
1830: Edwin Budding invents the lawn mower.	Lawn mower	
1831: Michael Faraday invents a method of electromagnetic induction. It would be independently invented by Joseph Henry the following year. Faraday is credited with inventing the first electric generator called the Faraday disk.	Electromagnetic induction	
1834: Moritz von Jacobi invents the first practical electric motor.	Electric motor	
1835: Joseph Henry invents the electromechanical relay.	Electromechanical relay	
1837: Samuel Morse invents Morse code.	Morse code	
1838: Moritz von Jacobi invents electrotyping.	Electrotyping	
1839: William Otis invents the steam shovel.	Steam shovel	
1839: James Nasmyth invents the steam hammer.	Steam hammer	
"1839: Edmond Becquerel invents a method for the photovoltaic effect, effectively producing the first solar cell."	Photovoltaic effect	
1839: Charles Goodyear invents vulcanized rubber.	Vulcanized rubber	
1840: John Herschel invents the blueprint.	Blueprint	
1841: Alexander Bain devises a printing telegraph.	Printing telegraph	
1842: William Robert Grove invents the first fuel cell.	Fuel cell	
"1842: John Bennet Lawes invents superphosphate, the first man-made fertilizer."	Fertilizer	
"1844: Friedrich Gottlob Keller and, independently, Charles Fenerty come up with the wood pulp method of paper production."	Wood pulp paper production	/wiki/Papermaking
1844: Francis Rynd invents the hypodermic needle.	Hypodermic needle	
"1847: Ascanio Sobrero invents Nitroglycerin, the first explosive made that was stronger than black powder."	Nitroglycerin	
1848: Jonathan J. Couch invents the pneumatic drill.	Pneumatic drill	
1848: Linus Yale Sr. invents the first modern pin tumbler lock.	Pin tumbler lock	
1849: Walter Hunt invents the first repeating rifle to use metallic cartridges (of his own design) and a spring-fed magazine.	Repeating rifle	
1849: Walter Hunt invents the Safety pin.	Safety pin	
1852: Elisha Otis invents the safety brake elevator.	Elevator	
"1855: James Clerk Maxwell invents the first practical method for color photography, whether chemical or electronic."	Color photography	
"1855: Henry Bessemer patents the Bessemer process for making steel, with improvements made by others over the following years."	Bessemer process	
"1856: Alexander Parkes invents parkesine, also known as celluloid, the first man-made plastic."	Plastic	
"1856: William Henry Perkin invents mauveine, the first synthetic dye."	Synthetic dye	
1857: Heinrich Geissler invents the Geissler tube.	Geissler tube	
"1859: Gaston Planté invents the lead acid battery, the first rechargeable battery."	Lead acid battery	
1860: Joseph Swan produces carbon fibers.	Carbon fibers	
1864: Louis Pasteur invents the pasteurization process.	Pasteurization	
"1867: Alfred Nobel invents dynamite, the first safely manageable explosive stronger than black powder."	Dynamite	
"1867: Lucien B. Smith invents barbed wire, which Joseph F. Glidden will modify in 1874, leading to the taming of the West and the end of the cowboys."	Barbed wire	
"1872: Polyvinyl chloride, more commonly known as vinyl, is synthesized by German chemist Eugen Baumann"	Vinyl	
1872: J.E.T. Woods and J. Clark invented stainless steel. Harry Brearley was the first to commercialize it.	Stainless steel	
1873: Frederick Ransome invents the rotary kiln.	Rotary kiln	
"1873: William Crookes, a chemist, invents the Crookes radiometer as the by-product of some chemical research."	Crookes radiometer	
1874: Gustave Trouvé invents the first metal detector.	Metal detector	
"1875: Fyodor Pirotsky invents the first electric tram near Saint Petersburg, Russia."	Electric tram	
"1876: Alexander Graham Bell has a patent granted for the telephone. However, other inventors before Bell had worked on the development of the telephone and the invention had several pioneers."	Telephone	
1877: Thomas Edison invents the first working phonograph.	Phonograph	
1878: Henry Fleuss is granted a patent for the first practical rebreather.	Rebreather	
"1879: Joseph Swan and Thomas Edison both patent a functional incandescent light bulb. Some two dozen inventors had experimented with electric incandescent lighting over the first three-quarters of the 19th century but never came up with a practical design. Swan's, which he had been working on since the 1860s, had a low resistance so was only suited for small installations. Edison designed a high-resistance bulb as part of a large-scale commercial electric lighting utility."	Incandescent light bulb	
"1881: Nikolay Benardos presents carbon arc welding, the first practical arc welding method."	Arc welding	
"1884: Hiram Maxim invents the recoil-operated Maxim gun, ushering in the age of semi- and fully automatic firearms."	Automatic firearms	
1884: Sir Charles Parsons invents the modern steam turbine.	Steam turbine	
1885: John Kemp Starley invents the modern safety bicycle.	Bicycle	
"1886: Carl Gassner invents the zinc–carbon battery, the first dry cell battery, making portable electronics practical."	Zinc–carbon battery	
1886: Charles Martin Hall and independently Paul Héroult invent the Hall–Héroult process for economically producing aluminum in 1886.	Hall-Héroult process	
1886: Karl Benz invents the first petrol or gasoline powered auto-mobile (car).	Car	
1887: James Blyth invents the first wind turbine used for generating electricity.	Wind turbine	
1888: John J. Loud invents the ballpoint pen.	Ballpoint pen	
1888: Thomas Edison and William Kennedy Dickson invent the Kinetoscope.	Kinetoscope	
"1888: The first practical pneumatic tire was made by Scotsman John Boyd Dunlop, the patent was from 1847 by Robert William Thomson"	Pneumatic tire	
1895: Frédéric Swarts invents the first chlorofluorocarbons to be applied as refrigerant.	Chlorofluorocarbon	
1890: Robert Gair would invent the pre-cut cardboard box.	Cardboard box	
1891: Whitcomb Judson invents the zipper.	Zipper	
1892: Léon Bouly invents the cinematograph.	Cinematograph	
1892: Thomas Ahearn invents the electric oven.	Electric oven	
1893: Rudolf Diesel invents the diesel engine (although Herbert Akroyd Stuart had experimented with compression ignition before Diesel).	Diesel engine	
"1893: William Stewart Halsted, invents the rubber glove for his wife Caroline Hampton as he noticed her hands were affected by the daily surgeries she had performed. The gloves were intended to prevent medical staff from developing dermatitis from surgical chemicals. The first modern disposable glove was created by Ansell Rubber Co. Pty. Ltd. in 1965."	Rubber glove	
1895: Guglielmo Marconi invents a system of wireless communication using radio waves.	Wireless telegraphy	
1895: Wilhelm Conrad Röntgen invented the first radiograph (X-ray).	X-ray	
"1897: Surgical masks made of cloth were developed in Europe by physicians Jan Mikulicz-Radecki at the University of Breslau and Paul Berger in Paris, as a result of increasing awareness of germ theory and the importance of antiseptic procedures in medicine."	Surgical mask	
"1898: Hans von Pechmann synthesizes polyethylene, now the most common plastic in the world."	Polyethylene	
1900: The first Zeppelin is designed by Theodor Kober.	Zeppelin	
"1901: The first motorized cleaner using suction, a powered ""vacuum cleaner"", is patented independently by Hubert Cecil Booth and David T. Kenney."	Vacuum cleaner	
1903: The first successful gas turbine is invented by Ægidius Elling.	Gas turbine	
1903: Édouard Bénédictus invents laminated glass.	Laminated glass	
"1904: The Fleming valve, the first vacuum tube and diode, is invented by John Ambrose Fleming."	Fleming valve	
"1907: Leo Baekeland invents bakelite,  the first plastic made from synthetic components."	Bakelite	
1908: Cellophane is invented by Jacques E. Brandenberger.	Cellophane	
1909: Fritz Haber invents the Haber process.	Haber process	
"1909: The first instantaneous transmission of images, or television broadcast, is carried out by Georges Rignoux and A. Fournier."	Television broadcast	/wiki/Television
"1911: The cloud chamber, the first particle detector, is invented by Charles Thomson Rees Wilson."	Cloud chamber	
1912: The first commercial slot cars or more accurately model electric racing cars operating under constant power were made by Lionel (USA) and appeared in their catalogues in 1912.	Slot car	
1912: The first use of articulated trams by Boston Elevated Railway.	Tram	
"1915: The first operational military tanks are designed in Great Britain and France. They are used in battle from 1916 and 1917 respectively. The designers in Great Britain are Walter Wilson and William Tritton and in France, Eugène Brillié. (Although it is known that vehicles incorporating at least some of the features of the tank were designed in a number of countries from 1903 onward, none reached a practical form.)"	Tank	
1917: The crystal oscillator is invented by Alexander M. Nicholson using a crystal of Rochelle Salt although his priority was disputed by Walter Guyton Cady.	Crystal oscillator	
1926: John Logie Baird demonstrates the world's first live working television system.	Mechanical television	
1927: The quartz clock is invented by Warren Marrison and J.W. Horton at Bell Telephone Laboratories.	Quartz clock	
"1928: Penicillin is first observed to exude antibiotic substances by Nobel laureate Alexander Fleming. Development of medicinal penicillin is attributed to a team of medics and scientists including Howard Walter Florey, Ernst Chain and Norman Heatley."	Penicillin	
"1928: Frank Whittle formally submitted his ideas for a turbo-jet engine. In October 1929, he developed his ideas further. On 16 January 1930, Whittle submitted his first patent (granted in 1932)."	Turbo-jet engine	
1928: Philo Farnsworth demonstrates the first practical electronic television to the press.	Electronic television	/wiki/Television
1929: The ball screw is invented by Rudolph G. Boehm.	Ball screw	
1930: The Supersonic combusting ramjet — Frank Whittle.	Supersonic combustion ramjet	/wiki/Scramjet
1930: The Phase-contrast microscopy is invented by Frits Zernike.	Phase-contrast microscopy	
1931: The electron microscope is invented by Ernst Ruska.	Electron microscope	
1933: FM radio is patented by inventor Edwin H. Armstrong.	FM radio	
"1933: Harry C. Jennings Sr. and Herbert Everest, both mechanical engineers, invented the first lightweight, steel, folding, portable wheelchair with their ""X-brace"" design."	Wheelchair	
"1935: Nylon, the first fully synthetic fiber is produced by Wallace Carothers while working at DuPont."	Nylon	
"1938: Z1, built by Konrad Zuse, is the first freely programmable computer in the world."	Freely programmable computer	/wiki/Z1_(computer)
"1938: Nuclear fission discovered in experiment by chemists Otto Hahn and Fritz Strassmann and physicists Lise Meitner and Otto Robert Frisch. The German nuclear energy project was based on this research. The Tube Alloys project and, subsequently, the Manhattan Project and the Soviet atomic bomb project were influenced by this research."	Nuclear fission	
1939: G. S. Yunyev or Naum Gurvich invented the electric current defibrillator	Defibrillator	
"1940: John Randall and Harry Boot would develop the high power, microwave generating, cavity magnetron, later applied to commercial Radar and Microwave oven appliances."	Cavity magnetron	
1941: Polyester is invented by John Rex Whinfield and James Dickson.	Polyester	
"1942: The V-2 rocket, the world's first long range ballistic missile, developed by engineer Wernher von Braun."	Ballistic missile	
"1945: The atomic bomb is developed by the Manhattan Project and swiftly used in August 1945 in the atomic bombings of Hiroshima and Nagasaki, effectively ending World War II."	Atomic bomb	
"1945: Percy Spencer, while employed at Raytheon, would patent a magnetron based microwave oven."	Microwave oven	
"1945: Willard Libby began his work on radiocarbon dating. He published his paper in 1946, a second paper in Science in 1947. Libby and James Arnold succeeded with the radiocarbon dating theory after results were published in Science in December 1949."	Radiocarbon dating	
"1946: James Martin invents the ejector seat, inspired by the death of his friend and test pilot Captain Valentine Baker in an aeroplane crash in 1942."	Ejector seat	
1947: Holography is invented by Dennis Gabor.	Holography	
1947: Floyd Farris and J.B. Clark (Stanolind Oil and Gas Corporation) invents hydraulic fracturing technology.	Hydraulic fracturing (fracking)	/wiki/Fracking
"1947: The first transistor, a bipolar point-contact transistor, is invented by John Bardeen and Walter Brattain under the supervision of William Shockley at Bell Labs."	Transistor	
1948: The first atomic clock is developed at the National Bureau of Standards.	Atomic clock	
"1948: Basic oxygen steelmaking is developed by Robert Durrer. The majority of steel manufactured in the world is produced using the basic oxygen furnace; in 2000, it accounted for 60% of global steel output."	Basic oxygen steelmaking	
"1950: Bertie the Brain, debatably the first video game, is displayed to the public at the Canadian National Exhibition."	Video games	/wiki/Video_game
1952: The float glass process is developed by Alastair Pilkington.	Float glass	
1952: The first thermonuclear weapon is developed.	Thermonuclear weapon	
"1953: The first video tape recorder, a helical scan recorder, is invented by Norikazu Sawazaki."	Video tape recorder	
"1954: Invention of the solar battery by Bell Telephone scientists, Calvin Souther Fuller, Daryl Chapin and Gerald Pearson capturing the Sun's power. First practical means of collecting energy from the Sun and turning it into a current of electricity."	Solar battery	
1955: The hovercraft is patented by Christopher Cockerell.	Hovercraft	
1956: The hard disk drive is invented by IBM.	Hard disk drive	
1957: The laser and optical amplifier are invented and named by Gordon Gould and Charles Townes. The laser and optical amplifier are foundational to powering the Internet.	Optical amplifier	
"1957: The first personal computer used by one person and controlled by a keyboard, the IBM 610, is invented by IBM."	Personal computer	
"1957: The first artificial satellite, Sputnik 1, is launched."	Satellite	
1958 – 1959: The integrated circuit is independently invented by Jack Kilby and Robert Noyce.	Integrated circuit	
"1959: The MOSFET (MOS transistor) is invented by the Egyptian Mohamed Atalla and the Korean Dawon Kahng at Bell Labs. It is used in almost all modern electronic products. It was smaller, faster, more reliable and cheaper to manufacture than earlier bipolar transistors, leading to a revolution in computers, controls and communication."	MOSFET	
1960: The first functioning laser is invented by Theodore Maiman.	Laser	
1963: The first electronic cigarette is created by Herbert A. Gilbert. Hon Lik is often credited with its invention as he developed the modern electronic cigarette and was the first to commercialize it.	Electronic cigarette	
"1964: Shinkansen, the first high-speed rail commercial passenger service."	High-speed rail	
1965: Kevlar is invented by Stephanie Kwolek at DuPont.	Kevlar	
"1969: The NPL network followed by the ARPANET implement packet switching for data communication, drawing on the concepts and designs of Donald Davies, and Paul Baran. These are considered precursors to the modern Internet."	NPL network	
"1960 - 1970: Public-key cryptography is invented and developed by James H. Ellis, Clifford Cocks, Malcolm J. Williamson, Whitfield Diffie, Martin Hellman, Ralph Merkle, Ron Rivest, Adi Shamir, Leonard Adleman, et al."	Public-key cryptography	
1970: The pocket calculator is invented.	Pocket calculator	
"1971: The first single-chip microprocessor, the Intel 4004, is invented. Its development was led by Federico Faggin, using his silicon-gate MOS technology. This led to the personal computer (PC) revolution."	Single-chip microprocessor	
"1971: The first space station, Salyut 1, is launched."	Space station	/wiki/Salyut_1
1971: IBM developed and released the world's first floppy disk and disk drive.	Floppy disk	
"1972: The first video game console, used primarily for playing video games on a TV, is the Magnavox Odyssey."	Video game console	
1973: The first fiber optic communication systems were developed by Optelecom.	Fiber-optic communication	
1973: The first commercial graphical user interface is introduced in 1973 on the Xerox Alto. The modern GUI is later popularized by the Xerox Star and Apple Lisa.	Graphical user interface	
1973: The first capacitive touchscreen is developed at CERN.	Touchscreen	
"1974: The Transmission Control Program is proposed by Vinton Cerf and Robert E. Kahn, building on the work of Louis Pouzin and other Internet pioneers, creating the basis for the modern Internet."	Internet	
"1974: The lithium-ion battery is invented by M. Stanley Whittingham, and further developed in the 1980s and 1990s by John B. Goodenough, Rachid Yazami and Akira Yoshino. It has impacted modern consumer electronics and electric vehicles."	Lithium-ion battery	
1974: The Rubik's cube is invented by Ernő Rubik which went on to be the best selling puzzle ever.	Rubik’s cube	
1977: Dr Walter Gilbert and Frederick Sanger invented a new DNA sequencing method for which they won the Nobel Prize.	DNA sequencing	
1977: The first self-driving car that did not rely upon rails or wires under the road is designed by the Tsukuba Mechanical Engineering Laboratory.	Self-driving car	
"1978: The Global Positioning System (GPS) enters service. While not the first Satellite navigation system, it is the first to enter widespread civilian use."	Global Positioning System	
"1979: The first handheld game console with interchangeable game cartridges, the Microvision is released."	Handheld game console	
1979: Nippon Telegraph and Telephone (NTT) launched the first cellular network in Japan.	Cellular network	
1980: Flash memory (both NOR and NAND types) was invented by Fujio Masuoka while working for Toshiba. It was formally introduced to the public in 1984.	Flash memory	
"1981: The first reusable spacecraft, the Space Shuttle undergoes test flights ahead of full operation in 1982."	Reusable spacecraft	
"1981: Kane Kramer develops the credit card-sized, IXI digital media player."	Digital media player	
"1982: A CD-ROM contains data accessible to, but not writable by, a computer for data storage and music playback. The 1985 Yellow Book standard developed by Sony and Philips adapted the format to hold any form of binary data."	CD-ROM	
"1982: Direct to home satellite television transmission, with the launch of Sky One service."	Satellite television	
"1982: The first laptop computer is launched, the 8/16-bit Epson HX-20."	Laptop	
1983: Stereolithography is invented by Chuck Hull.	Stereolithography	
"1984: The first commercially available cell phone in the US, the DynaTAC 8000X, is created by Motorola."	Mobile phone	/wiki/Motorola_DynaTAC
1984: DNA profiling is pioneered by Alec Jeffreys.	DNA profiling	
"1989: Karlheinz Brandenburg would publish the audio compression algorithms that would be standardised as the: MPEG-1, layer 3 (mp3), and later the MPEG-2, layer 7 Advanced Audio Compression (AAC)."	MP3	
1989: The World Wide Web is invented by computer scientist Tim Berners-Lee.	World Wide Web	
"1990: The first search engine invented was “Archie”, created by Alan Emtage a student at McGill University in Montreal."	Search engine	/wiki/Archie_(search_engine)
1991: The first commercial flash-based solid-state drive is launched by SunDisk.	Solid-state drive	
1991: The first sim card is developed by Munich smart-card maker Giesecke &amp; Devrient.	SIM card	
1993: IBM created the first mobile app with SIMON; it had 10 built-in apps from Email to Calendar.	Mobile app	/wiki/IBM_Simon
"1994: IBM Simon, the world's first smartphone, is developed by IBM."	Smartphone	/wiki/IBM_Simon
1994: First generation of Bluetooth is developed by Ericsson Mobile. A form of data communication on short distances between electronic devices.	Bluetooth	
1994: A Tetris variant on the Hagenuk MT-2000 device becomes the first mobile game.	Mobile game	
"1995: DVD is an optical disc storage format, invented and developed by Philips, Sony, Toshiba, and Panasonic in 1995. DVDs offer higher storage capacity than compact discs while having the same dimensions."	DVD	
1995: Match.com launches as the first dating site ever and is the number 1 most visited dating site in the US.	Online dating	
1995: Waiter.com launches as the first online food ordering service.	Online food ordering	
"1996: Mobile web was first commercially offered in Finland on the Nokia 9000 Communicator phone, and it was also the first phone with texting."	Mobile web	/wiki/Nokia_9000_Communicator
1996: Bolt and Six Degrees (1997) both become the first social media sites.	Social media	
1998: The first portable MP3 player was released by SaeHan Information Systems.	Portable media player	
"1998: The search engine Google, is launched."	Google	
"1999: The first digital video recorder (DVR), the TiVo, is launched by Xperi."	Digital video recorder	
2000: Sony develops the first prototypes for the Blu-ray optical disc format. The first prototype player was released in 2004.	Blu-ray	
"2000: First documented placement of Geocaching, an outdoor recreational activity, in which participants use a Global Positioning System (GPS) receiver or mobile device and other navigational techniques to hide and seek containers, took place on May 3, 2000, by Dave Ulmer of Beavercreek, Oregon."	Geocaching	
"2004: First podcast, invented by Adam Curry and Dave Winer, is a program made available in digital format for download over the Internet and it usually features one or more recurring hosts engaged in a discussion about a particular topic or current event."	Podcast	
"2005: YouTube, the first popular video-streaming site, was founded"	Video-streaming website	/wiki/YouTube
2007: Netflix debuted the first popular video-on-demand service	Video-on-demand	
2007: Apple Inc. released the iPhone	iPhone	
"2007: First Kindle introduced by Amazon (company) founder and CEO Jeff Bezos, who instructed the company's employees to build the world's best e-reader before Amazon's competitors could. Amazon originally used the codename Fiona for the device. This hardware evolved from the original Kindle introduced in 2007 and the Kindle DX (with its larger 9.7"" screen) introduced in 2009."	E-reader	
2008: Satoshi Nakamoto develops the first blockchain.	Blockchain	
"2010: The first solar sail based spacecraft, IKAROS."	Solar sail based aircraft	/wiki/Solar_sail
2010: The first quantum machine	Quantum machine	
"2010: The first synthetic organism, Mycoplasma laboratorium is created by the J. Craig Venter Institute"	Synthetic organism	/wiki/Synthetic_biology
2013: Cancer immunotherapy	Cancer immunotherapy	
2015: CRISPR genome-editing method	CRISPR genome-editing method	/wiki/CRISPR
2020: The first MRNA vaccine to be approved by public health medicines regulators is co-developed by Pfizer and BioNTech for COVID-19.	MRNA vaccine	